exuberant - буйный
dopey = вялый/одурманенный
flask - колба
prick - yколоть
flunked - завалить
curious - любопытно
no adulterants - без примесей
fumes - испарения
faggot - педик
boonies - глубинка(задница)
evasive - ускользающий
negotiate - договориться
cleavage - декольте
apparently - видимо
brassiere - лифчик
concerned - обеспокоенный
coast is clear - путь свободен
pounce - внезапно атаковать
decent - приличный
bide - ждать
begging - попрошайничать
flimsy - хлипкий
appoinment - встреча
fabulous - поразительно
hesitate - сомневаться
squeaking - скрипеть
sacred - священный
offence - оскорбление
poison - яд
evidence -  доказательсво
stakeout - засада
swabbed - протерли
kingpin - главарь
mice - мышь
hang out - тусоваться
charity - благотворительность
intestinal - кишечный
fatigued - усталый
curable - излечимый
aches - боль
nausea - тошнота
kidney - почка
irritation - раздрожение
wind up - столкнуться
conclusive - окончательный
attorney - адвокат
duds - шмотки
probation - испытательный срок
upstanding citizen - добропорядочный гражданин
toke - затяжка
complaining - жаловаться
invent - придумывать
appealing - привлекательный
affairs - дела
glassware - стеклянная посуда
ditch - канава
wrecked - разбил
beaker - химический стакан
javelinas - дротики
mess you up - я тебя изобью
misarble - убогий(несчастный)
courtesy - любезность
realm - область(сфера)
blooshed - кровопролитие
whatever - что угодно
dizzy - испытывать головокружение
crawled - прополз
vouch - ручаться
abandoned - заброшеный
buzzards - стервятники
underestimate - недооценивать
solicitous - заботливый
hernia  - грыжа
janitor - двойник
groundskeepers -  садовники
appointment - встреча
wised up - поумнел
waddling - переваливаться(ходить в развалку)
efficacy  - эффективность
enlighten - просвящать
Gap - разрыв/промежуток(во времени например)
furnace - печь
sweat lodge - парилка
without a shred - без остатка
modicum - хоть немного
detained - задержали
innocent - невиновный
dank - сырой
hostage - заложник
accused - обвиняет
admit - признаться


doable - выполнимо
buzzards - стервятники
lingo - слэнг
jynkyard - свалка
witnesses - свидетели
feelers - шyпальца
gals - девочки
arrange - договориться
anticipation - предвкушение
grow tumescent - разбухать
repute - репутация
whacked - избитый
manhunt - розыск
agitated - возбужден
wander - бродить
collateral - залог
dissapoint - разочарование
affair - роман
grasping at straws - хвататься за соломинку
moronic - дибил
convince - убедить
lucid - осознанный
fluid - жидкость
ascertained - установлено(констатированно)
sought - искал
proceed - продолжать
engage - вступать в бой
acquaintances - знакомые
sacrilege - кощунство
antitussive - противокашлевое
prescription - рецепт
presume - предположу
unclaimed - невостребованные
interdiction - запрет
van - фургон
recurring - повторяющайся
guilt - вина
persecution - преследование
hutchhiked 
thirsty - испытывать жажду
felony - преступление
vacate - освободите
pursuit - преследовать
prey - добыча
labor - труд(работа)
neatly - аккуратно
gory - кровавые
breakage - поломка
sustanable - стабильный
precious - драгоценная
ashamed - пристыженный
bury - хоронить
no wonder - не удивительно
overdue - запоздалый
adamant - непреклонный
rewarded - наградили
concussion - сотрясение мозга
skank - шалава
regret involving
selfish - эгоистичный
verge - грань
jog your memory - в
intimidation - угроза(запугивание)
satellite - спутниковый
profusely - щедро
commitment - обязательство
inconspicuous - незаметно
obligated - обязан
lousy - паршиво
pal - приятель
allegedly - якобы(предположительно)
barely - едва, только
whorehouse - бордель
clientele - клиентура
digress - отвлекся
vicious - беспощадный
desperate - отчаянный
bribe - взятка
morally outraged - морально возмущен
facilitating - содействие
conscience - совесть
pathetic - жалкие
extenuating circumstances - смягчающие обстоятельства
forgive me - прости меня
endgewise - в конце концов
congenital - врожденно
teasing - дразнить
cured - вылеченный
tumour - опухоль
shurnk - сжалась
tissue inflammation - воспаление тканей
oesophagus - пищевод
rupture - разрыв
beverage - напиток
kindnesses - доброта
sappy - сентементальный
gratitude - благодарности
pouch - сумка
haunches - бедра
indeed - в самом деле
holler - вопль(крик)
misred - ошибся
fungus - плесень
postpone - отложить
envy - завидовать
setback - неудача
turf dispute - спор о территории
outstanding - замечательно
peddling - продажа
commodity - товар
obscene - непристойно
skittish - пугливый 
impeccable - безупречный
dribs and drabs - обрывки
mortgage - ипотечный кредит
enchant - зачаровать
trooper - рядовой
zits - прыщи
tummy - живот
soliciting - выпрашивать
rattling - дребезжание
taught - учил
servant - слуга
needle - игла
preach - проповедовать
blackmail - шантаж
obstensilty - упрямство
dial - набирать номер
skim - обезжиренное
porch - порог
